1 4 3 1 2 
1 0 3 1 4 
1 1 3 4 4 
2 2 1 2 1 
2 2 1 0 3 
0 0 1 2 1
1