3 3 3 2 2
3 4 0 1 0
3 0 1 1 4
1 3 1 4 1
4 3 2 2 4
3 2 0 1 3
2