0 2 1 4 1
3 2 2 1 0
1 1 0 0 1
1 3 1 0 0
3 4 3 0 2
1 3 1 3 3
2