1 1 1 4 2
4 3 3 4 0
1 1 0 2 4
1 1 3 4 3
0 0 4 1 0
2 0 3 2 0
5