0 1 2 1 2
3 2 1 0 2
3 0 1 2 4
4 4 1 2 3
0 1 2 2 4
4 0 4 4 2
3