2 4 1 0 4
1 2 0 2 1
2 1 1 2 2
2 3 1 2 0
0 3 4 2 4
3 1 1 3 2
1