4 2 4 1 2
1 1 4 1 3
1 1 4 2 4
3 2 2 1 3
3 2 1 0 1
1 1 1 4 1
2