2 2 2 2 2 
2 1 2 1 2 
2 0 1 0 2 
2 0 1 0 2 
2 1 3 1 2 
2 2 2 2 2
1