1 0 0 4 3
4 1 0 1 3
3 2 2 4 0
2 1 0 1 3
0 3 2 1 1
1 4 0 4 4
2