3 4 1 3 1
1 2 4 1 3
3 2 3 2 3
0 4 1 3 3
1 3 2 1 1 
1 4 0 3 0
4