4 2 2 3 1
0 2 0 1 2
4 1 3 4 4
4 1 1 4 1
1 2 3 1 1
1 0 3 3 0
1