2 2 4 2 2
4 2 1 1 0
2 3 4 0 1
3 4 2 3 2
3 1 1 2 1
0 4 1 2 4
2