0 3 4 0 0
2 0 3 1 1
1 2 4 1 2
0 1 1 4 1
3 3 3 0 4
2 2 4 2 1
4