4 0 2 0 4
0 1 0 2 1
3 2 1 1 2
4 3 1 0 0
3 4 2 3 4
4 4 1 0 1
6