0 3 2 4 0 
1 1 1 2 0 
0 1 4 1 2 
0 4 2 0 1 
1 1 1 2 2 
0 4 0 1 1
1