0 2 0 4 1
3 3 2 1 0
0 1 0 0 3
1 3 2 2 1
0 0 0 2 1
2 2 2 3 2
3