4 0 1 4 4
4 1 1 2 3
3 4 0 3 3
0 1 1 1 3
3 2 1 3 1
2 0 3 1 1
2