1 2 3 0 1
3 2 4 4 3
0 2 1 1 2
3 1 3 2 2
4 2 1 3 2
1 4 0 2 4
1