2 4 3 1 1
0 2 4 2 2 
1 4 0 1 2
1 1 2 1 0
3 3 1 3 0
2 2 4 0 4
2