0 1 1 1 4
1 1 2 1 2 
4 1 3 0 2
4 3 4 1 4
0 1 0 2 2
1 0 0 3 2
2
